2 TestSet2 83
8.5.Level1
********
*B*....*
*.*.**.*
*.*..*.*
*.*..*.*
*.**.*.*
*....*B*
********
8.7.Level2
********
*B*R...*
*.*.**.*
*.*..*.*
*.*..*.*
*.**.*.*
*...R*B*
********
8.8.Level3
********
*B*R..Y*
*.*.**.*
*.*..*.*
*.*..*.*
*.**.*.*
*Y..R*B*
********
8.6.Level4
********
*B*....*
*.*..*.*
*.*YR*.*
*.*RY*.*
*.*..*.*
*....*B*
********
8.4.Level5
********
*B*....*
*.*G.*.*
*.*YR*.*
*.*RY*.*
*.*.G*.*
*....*B*
********
8.7.Level6
********
*B*....*
*.*G**.*
*.*YR*.*
*.*RY*.*
*.**G*.*
*....*B*
********
8.6.Level7
********
*.*B...*
*.*G**.*
*.*YR*.*
*.*RY*.*
*.**G*.*
*...B*.*
********
8.11.Level8
********
*B*....*
*R*.**.*
*.*..*.*
*.*..*.*
*.**.*R*
*....*B*
********
8.13.Level9
********
*B*....*
*R*.**.*
*P*..*.*
*.*..*P*
*.**.*R*
*....*B*
********
%END%