1 TestSet1 83
8.1.Level1
........
........
.******.
.*.B..*.
.*...B*.
.******.
........
........
8.2.Level2
........
........
.******.
.*....*.
.*.B*B*.
.******.
........
........
8.2.Level3
........
....***.
.****B*.
.*....*.
.*.B*.*.
.******.
........
........
8.5.Level4
........
.******.
.*B**B*.
.*....*.
.*..*R*.
.*.R***.
.****...
........
8.6.Level5
........
.******.
.*B*B.*.
.*....*.
.*..*R*.
.*.R***.
.****...
........
8.4.Level6
........
.******.
.**B*B*.
.*....*.
.*R*R**.
.******.
........
........
8.4.Level7
********
*...*..*
*......*
*..*.YB*
*.....R*
*...*YB*
*.*...R*
********
8.4.Level8
********
*...*B.*
*.....R*
*...*.Y*
*....RB*
*...*.Y*
*......*
********
8.4.Level9
********
*...*B.*
*.....R*
*.*.*Y**
**..BR.*
*...*.Y*
*......*
********
%END%