3 TestSet3 83
8.4.Level1
********
*...BR.*
*......*
*..*...*
*...*..*
*......*
*.RB...*
********
8.4.Level2
********
*...BR.*
*......*
*..*P..*
*..P*..*
*......*
*.RB...*
********
8.4.Level3
********
*..RBRB*
*......*
*..*...*
*...*..*
*......*
*......*
********
8.4.Level4
********
*.RBRB.*
*......*
*..*...*
*...*..*
*......*
*......*
********
8.4.Level5
********
*RPBRPB*
*......*
*..*...*
*...*..*
*......*
*......*
********
8.4.Level6
********
*..RBRB*
*......*
*..*.*.*
*..P*P.*
*......*
*......*
********
8.4.Level7
********
*....RB*
*......*
*.P*G*.*
*.*G*P.*
*......*
*RB....*
********
8.4.Level8
********
*...GRB*
*......*
*..*.*.*
*.*.*..*
*......*
*RBG...*
********
8.4.Level9
********
*....RB*
*....PG*
*..*.*.*
*.*.*..*
*GP....*
*RB....*
********
%END%